#.........
#.......#.
..@..#....
#....#..#.
..........
#.#..#....
#.......#.
..#.......
........#.
#..##..#..
